111111111111110
200020000020002
200020000020002
200000000000002
200111001110002
200000000000002
200000000000002
200200020002002
200200020002002
200000000000002
200111111110002
200000000000002
231111111111112