311111111111114
200020000020002
200020000020002
200888000888002
200000000000002
200888000888002
200000000000002
200200020002002
200200020002002
200000000000002
200088888880002
200000000000002
611111111111115