511111111111111
200000000000002
200000000000002
200000000000002
200000000000002
200000000000002
200000000000002
200000000000002
200000000000002
200000000000002
200000000000002
200000000000002
411111111111113