311111111111114
200000000000002
200000000000002
200000000000002
200000000000002
200000000000002
200000000000002
200000000000002
200000000000002
200000000000002
200001111100002
200000000000002
611111111111115