11111111111111111111111111111111111111111111111111
10200000000000000000000000000000000000000000000001
10000001000000000000000000000000000000000000000001
11111111000000000000000000000000000000000000000001
10000000000000000000000000000000000000000000000001
10000000000000000000000111111111111110000000100001
10000000000000000000000000111111110000000000100001
10000000000000000000000000001110000000000000100001
10000000000000000000000000000000000000000000100001
10000011111111000000000000000000000000000000100001
10000000011000000000000000000000000000000000100001
10000000001000000000000111111110000000000000100011
10000000000110000000000000000000000000000000100001
10000000000000000000000000000000000000000000100001
10000000000000000000000000000000000000000000100001
10000000000000000000000000000000000111100000000001
10000000000000000000000000000000000000100000000001
10000222211111000000000000000000000000100000000001
10000000000000000000000000000000000000000000000001
10000000000000000000000000000000000000000000000001
10000000000000000000000000000222222222200000000001
10000000000000000000000000000222222222200000000001
10000000000000000000000000000222222222200000100001
10000001111111100000000000000222222222200000100001
10000000000000000000000000000222222222200000100001
10000000000000011111110000000000000000000000100001
10000000000000000000000000000000000000000000100001
10000000000000000000000011111111100000000000100001
10000000000000000000000000000000000000000000000001
10000000000000000000000000000000000000000000000001
12222222222222222222222222222222222222222222111111